"filename", "language", "Python", "JavaScript", "CSS", "HTML", "comment", "blank", "total"
"/Users/xuanpeichen/Desktop/code/python/openai/game/action.py", "Python", -11, 0, 0, 0, 0, -5, -16
"/Users/xuanpeichen/Desktop/code/python/openai/game/card.py", "Python", 35, 0, 0, 0, 13, 9, 57
"/Users/xuanpeichen/Desktop/code/python/openai/game/custom_print.py", "Python", 9, 0, 0, 0, 5, 4, 18
"/Users/xuanpeichen/Desktop/code/python/openai/game/game_function_tool.py", "Python", 75, 0, 0, 0, 5, 13, 93
"/Users/xuanpeichen/Desktop/code/python/openai/game/player.py", "Python", 128, 0, 0, 0, 13, 40, 181
"/Users/xuanpeichen/Desktop/code/python/openai/game/room.py", "Python", 170, 0, 0, 0, 22, 53, 245
"/Users/xuanpeichen/Desktop/code/python/openai/game/room_server.py", "Python", 16, 0, 0, 0, 0, 6, 22
"/Users/xuanpeichen/Desktop/code/python/openai/game/type_action/actions.py", "Python", 159, 0, 0, 0, 6, 77, 242
"/Users/xuanpeichen/Desktop/code/python/openai/game/type_cards/creature.py", "Python", 33, 0, 0, 0, 2, 16, 51
"/Users/xuanpeichen/Desktop/code/python/openai/game/type_cards/instant.py", "Python", 17, 0, 0, 0, 0, 4, 21
"/Users/xuanpeichen/Desktop/code/python/openai/game/type_cards/land.py", "Python", 33, 0, 0, 0, 1, 7, 41
"/Users/xuanpeichen/Desktop/code/python/openai/game/type_cards/sorcery.py", "Python", 17, 0, 0, 0, 0, 4, 21
"/Users/xuanpeichen/Desktop/code/python/openai/pycards/creature/Merfolk_Wayfinder/model.py", "Python", 3, 0, 0, 0, 0, 0, 3
"/Users/xuanpeichen/Desktop/code/python/openai/pycards/creature/Mistweaver_Adept/model.py", "Python", 14, 0, 0, 0, 0, 3, 17
"/Users/xuanpeichen/Desktop/code/python/openai/pycards/creature/Raging_Firekin/model.py", "Python", 1, 0, 0, 0, 0, 1, 2
"/Users/xuanpeichen/Desktop/code/python/openai/pycards/creature/Torrent_Elemental/model.py", "Python", 2, 0, 0, 0, 0, 1, 3
"/Users/xuanpeichen/Desktop/code/python/openai/server.py", "Python", 18, 0, 0, 0, 7, 3, 28
"/Users/xuanpeichen/Desktop/code/python/openai/server_start.py", "Python", 17, 0, 0, 0, 1, 6, 24
"/Users/xuanpeichen/Desktop/code/python/openai/webpages/block.js", "JavaScript", 0, 3, 0, 0, 0, 1, 4
"/Users/xuanpeichen/Desktop/code/python/openai/webpages/card.js", "JavaScript", 0, 1, 0, 0, 1, 1, 3
"/Users/xuanpeichen/Desktop/code/python/openai/webpages/deckpage/style.css", "CSS", 0, 0, 1, 0, 1, 0, 2
"/Users/xuanpeichen/Desktop/code/python/openai/webpages/gaming_page/2D_show.js", "JavaScript", 0, 59, 0, 0, 2, 13, 74
"/Users/xuanpeichen/Desktop/code/python/openai/webpages/gaming_page/action_bar.js", "JavaScript", 0, 57, 0, 0, 5, 20, 82
"/Users/xuanpeichen/Desktop/code/python/openai/webpages/gaming_page/animation.js", "JavaScript", 0, 266, 0, 0, 34, 54, 354
"/Users/xuanpeichen/Desktop/code/python/openai/webpages/gaming_page/card_battle.js", "JavaScript", 0, 50, 0, 0, 14, 18, 82
"/Users/xuanpeichen/Desktop/code/python/openai/webpages/gaming_page/card_battle_main.js", "JavaScript", 0, 64, 0, 0, 1, 12, 77
"/Users/xuanpeichen/Desktop/code/python/openai/webpages/gaming_page/card_hand.js", "JavaScript", 0, 101, 0, 0, 26, 48, 175
"/Users/xuanpeichen/Desktop/code/python/openai/webpages/gaming_page/card_hand_main.js", "JavaScript", 0, 2, 0, 0, 2, 0, 4
"/Users/xuanpeichen/Desktop/code/python/openai/webpages/gaming_page/gaming.html", "HTML", 0, 0, 0, 8, -3, 4, 9
"/Users/xuanpeichen/Desktop/code/python/openai/webpages/gaming_page/gaming.js", "JavaScript", 0, 338, 0, 0, 61, 99, 498
"/Users/xuanpeichen/Desktop/code/python/openai/webpages/gaming_page/mana_bar.js", "JavaScript", 0, 8, 0, 0, 0, 1, 9
"/Users/xuanpeichen/Desktop/code/python/openai/webpages/gaming_page/message_processor.js", "JavaScript", 0, 327, 0, 0, 96, 60, 483
"/Users/xuanpeichen/Desktop/code/python/openai/webpages/gaming_page/player.js", "JavaScript", 0, 46, 0, 0, 5, 8, 59
"/Users/xuanpeichen/Desktop/code/python/openai/webpages/gaming_page/selection_page.js", "JavaScript", 0, 234, 0, 0, 10, 40, 284
"/Users/xuanpeichen/Desktop/code/python/openai/webpages/gaming_page/special_effects.js", "JavaScript", 0, 282, 0, 0, 31, 76, 389
"/Users/xuanpeichen/Desktop/code/python/openai/webpages/gaming_page/table.js", "JavaScript", 0, 78, 0, 0, 28, 34, 140
"/Users/xuanpeichen/Desktop/code/python/openai/webpages/gaming_page/table_block.js", "JavaScript", 0, 14, 0, 0, 1, 5, 20
"/Users/xuanpeichen/Desktop/code/python/openai/webpages/gaming_page/timmer.js", "JavaScript", 0, 158, 0, 0, 14, 34, 206
"Total", "-", 736, 2088, 1, 8, 404, 770, 4007