"filename", "language", "Python", "CSS", "JavaScript", "HTML", "comment", "blank", "total"
"/Users/xuanpeichen/Desktop/code/python/openai/card_python_creator.py", "Python", 166, 0, 0, 0, 5, 75, 246
"/Users/xuanpeichen/Desktop/code/python/openai/database.py", "Python", 26, 0, 0, 0, 0, 7, 33
"/Users/xuanpeichen/Desktop/code/python/openai/game/action.py", "Python", 7, 0, 0, 0, 0, 3, 10
"/Users/xuanpeichen/Desktop/code/python/openai/game/card.py", "Python", 40, 0, 0, 0, 3, 21, 64
"/Users/xuanpeichen/Desktop/code/python/openai/game/game_function_tool.py", "Python", 66, 0, 0, 0, 0, 23, 89
"/Users/xuanpeichen/Desktop/code/python/openai/game/player.py", "Python", 68, 0, 0, 0, 15, 44, 127
"/Users/xuanpeichen/Desktop/code/python/openai/game/pydantic_model.py", "Python", 15, 0, 0, 0, 0, 10, 25
"/Users/xuanpeichen/Desktop/code/python/openai/game/room.py", "Python", 32, 0, 0, 0, 10, 31, 73
"/Users/xuanpeichen/Desktop/code/python/openai/game/room_server.py", "Python", 47, 0, 0, 0, 0, 39, 86
"/Users/xuanpeichen/Desktop/code/python/openai/game/type_action/actions.py", "Python", 23, 0, 0, 0, 0, 17, 40
"/Users/xuanpeichen/Desktop/code/python/openai/game/type_cards/creature.py", "Python", 38, 0, 0, 0, 2, 28, 68
"/Users/xuanpeichen/Desktop/code/python/openai/game/type_cards/instant.py", "Python", 10, 0, 0, 0, 0, 9, 19
"/Users/xuanpeichen/Desktop/code/python/openai/game/type_cards/land.py", "Python", 17, 0, 0, 0, 0, 15, 32
"/Users/xuanpeichen/Desktop/code/python/openai/game/type_cards/sorcery.py", "Python", 10, 0, 0, 0, 0, 10, 20
"/Users/xuanpeichen/Desktop/code/python/openai/pycards/Instant/Aquatic_Evasion/model.py", "Python", 12, 0, 0, 0, 0, 12, 24
"/Users/xuanpeichen/Desktop/code/python/openai/pycards/Instant/Arcane_Inferno/model.py", "Python", 12, 0, 0, 0, 0, 12, 24
"/Users/xuanpeichen/Desktop/code/python/openai/pycards/Instant/Arcane_Insight/model.py", "Python", 12, 0, 0, 0, 0, 12, 24
"/Users/xuanpeichen/Desktop/code/python/openai/pycards/Instant/Arcane_Intervention/model.py", "Python", 12, 0, 0, 0, 0, 12, 24
"/Users/xuanpeichen/Desktop/code/python/openai/pycards/Instant/Arcane_Reflection/model.py", "Python", 12, 0, 0, 0, 0, 12, 24
"/Users/xuanpeichen/Desktop/code/python/openai/pycards/Instant/Astral_Resurgence/model.py", "Python", 12, 0, 0, 0, 0, 12, 24
"/Users/xuanpeichen/Desktop/code/python/openai/pycards/Instant/Avenging_Light/model.py", "Python", 12, 0, 0, 0, 0, 12, 24
"/Users/xuanpeichen/Desktop/code/python/openai/pycards/Instant/Blazing_Reversal/model.py", "Python", 12, 0, 0, 0, 0, 12, 24
"/Users/xuanpeichen/Desktop/code/python/openai/pycards/Instant/Celestial_Convergence/model.py", "Python", 12, 0, 0, 0, 0, 12, 24
"/Users/xuanpeichen/Desktop/code/python/openai/pycards/Instant/Celestial_Intervention/model.py", "Python", 12, 0, 0, 0, 0, 12, 24
"/Users/xuanpeichen/Desktop/code/python/openai/pycards/Instant/Celestial_Rebirth/model.py", "Python", 12, 0, 0, 0, 0, 12, 24
"/Users/xuanpeichen/Desktop/code/python/openai/pycards/Instant/Divine_Intervention/model.py", "Python", 12, 0, 0, 0, 0, 12, 24
"/Users/xuanpeichen/Desktop/code/python/openai/pycards/Instant/Divine_Reprisal/model.py", "Python", 12, 0, 0, 0, 0, 12, 24
"/Users/xuanpeichen/Desktop/code/python/openai/pycards/Instant/Ephemeral_Bolt/model.py", "Python", 12, 0, 0, 0, 0, 12, 24
"/Users/xuanpeichen/Desktop/code/python/openai/pycards/Instant/Ephemeral_Insight/model.py", "Python", 12, 0, 0, 0, 0, 12, 24
"/Users/xuanpeichen/Desktop/code/python/openai/pycards/Instant/Ephemeral_Response/model.py", "Python", 12, 0, 0, 0, 0, 12, 24
"/Users/xuanpeichen/Desktop/code/python/openai/pycards/Instant/Ephemeral_Vision/model.py", "Python", 12, 0, 0, 0, 0, 12, 24
"/Users/xuanpeichen/Desktop/code/python/openai/pycards/Instant/Ethereal_Convergence/model.py", "Python", 12, 0, 0, 0, 0, 12, 24
"/Users/xuanpeichen/Desktop/code/python/openai/pycards/Instant/Ethereal_Reversal/model.py", "Python", 12, 0, 0, 0, 0, 12, 24
"/Users/xuanpeichen/Desktop/code/python/openai/pycards/Instant/Ethereal_Surge/model.py", "Python", 12, 0, 0, 0, 0, 12, 24
"/Users/xuanpeichen/Desktop/code/python/openai/pycards/Instant/Fiery_Blast/model.py", "Python", 12, 0, 0, 0, 0, 12, 24
"/Users/xuanpeichen/Desktop/code/python/openai/pycards/Instant/Flames_of_Fury/model.py", "Python", 12, 0, 0, 0, 0, 12, 24
"/Users/xuanpeichen/Desktop/code/python/openai/pycards/Instant/Honorable_Protection/model.py", "Python", 12, 0, 0, 0, 0, 12, 24
"/Users/xuanpeichen/Desktop/code/python/openai/pycards/Instant/Mindweave/model.py", "Python", 12, 0, 0, 0, 0, 12, 24
"/Users/xuanpeichen/Desktop/code/python/openai/pycards/Instant/Mystic_Confluence/model.py", "Python", 12, 0, 0, 0, 0, 12, 24
"/Users/xuanpeichen/Desktop/code/python/openai/pycards/Instant/Mystic_Convergence/model.py", "Python", 12, 0, 0, 0, 0, 12, 24
"/Users/xuanpeichen/Desktop/code/python/openai/pycards/Instant/Mystic_Evasion/model.py", "Python", 12, 0, 0, 0, 0, 12, 24
"/Users/xuanpeichen/Desktop/code/python/openai/pycards/Instant/Mystic_Evocation/model.py", "Python", 12, 0, 0, 0, 0, 12, 24
"/Users/xuanpeichen/Desktop/code/python/openai/pycards/Instant/Mystic_Insight/model.py", "Python", 12, 0, 0, 0, 0, 12, 24
"/Users/xuanpeichen/Desktop/code/python/openai/pycards/Instant/Mystic_Reflection/model.py", "Python", 12, 0, 0, 0, 0, 12, 24
"/Users/xuanpeichen/Desktop/code/python/openai/pycards/Instant/Mystic_Reversal/model.py", "Python", 12, 0, 0, 0, 0, 12, 24
"/Users/xuanpeichen/Desktop/code/python/openai/pycards/Instant/Mystic_Rupture/model.py", "Python", 12, 0, 0, 0, 0, 12, 24
"/Users/xuanpeichen/Desktop/code/python/openai/pycards/Instant/Mystic_Tide/model.py", "Python", 12, 0, 0, 0, 0, 12, 24
"/Users/xuanpeichen/Desktop/code/python/openai/pycards/Instant/Mystic_Tides/model.py", "Python", 12, 0, 0, 0, 0, 12, 24
"/Users/xuanpeichen/Desktop/code/python/openai/pycards/Instant/Mystical_Barrier/model.py", "Python", 12, 0, 0, 0, 0, 12, 24
"/Users/xuanpeichen/Desktop/code/python/openai/pycards/Instant/Mystical_Shift/model.py", "Python", 12, 0, 0, 0, 0, 12, 24
"/Users/xuanpeichen/Desktop/code/python/openai/pycards/Instant/Naturalize/model.py", "Python", 12, 0, 0, 0, 0, 12, 24
"/Users/xuanpeichen/Desktop/code/python/openai/pycards/Instant/Nature_s_Reprisal/model.py", "Python", 12, 0, 0, 0, 0, 12, 24
"/Users/xuanpeichen/Desktop/code/python/openai/pycards/Instant/Overgrowth_Surge/model.py", "Python", 12, 0, 0, 0, 0, 12, 24
"/Users/xuanpeichen/Desktop/code/python/openai/pycards/Instant/Phantasmal_Distortion/model.py", "Python", 12, 0, 0, 0, 0, 12, 24
"/Users/xuanpeichen/Desktop/code/python/openai/pycards/Instant/Primal_Surge/model.py", "Python", 12, 0, 0, 0, 0, 12, 24
"/Users/xuanpeichen/Desktop/code/python/openai/pycards/Instant/Pyroblast_Surge/model.py", "Python", 12, 0, 0, 0, 0, 12, 24
"/Users/xuanpeichen/Desktop/code/python/openai/pycards/Instant/Resurgence/model.py", "Python", 12, 0, 0, 0, 0, 12, 24
"/Users/xuanpeichen/Desktop/code/python/openai/pycards/Instant/Sacred_Reinforcement/model.py", "Python", 12, 0, 0, 0, 0, 12, 24
"/Users/xuanpeichen/Desktop/code/python/openai/pycards/Instant/Shadow_Snare/model.py", "Python", 12, 0, 0, 0, 0, 12, 24
"/Users/xuanpeichen/Desktop/code/python/openai/pycards/Instant/Shadowform_Surge/model.py", "Python", 12, 0, 0, 0, 0, 12, 24
"/Users/xuanpeichen/Desktop/code/python/openai/pycards/Instant/Shadowstrike/model.py", "Python", 12, 0, 0, 0, 0, 12, 24
"/Users/xuanpeichen/Desktop/code/python/openai/pycards/Instant/Summoner_s_Respite/model.py", "Python", 12, 0, 0, 0, 0, 12, 24
"/Users/xuanpeichen/Desktop/code/python/openai/pycards/Instant/Swift_Ward/model.py", "Python", 12, 0, 0, 0, 0, 12, 24
"/Users/xuanpeichen/Desktop/code/python/openai/pycards/Instant/Temporal_Manipulation/model.py", "Python", 12, 0, 0, 0, 0, 12, 24
"/Users/xuanpeichen/Desktop/code/python/openai/pycards/Instant/Temporal_Reversal/model.py", "Python", 12, 0, 0, 0, 0, 12, 24
"/Users/xuanpeichen/Desktop/code/python/openai/pycards/Instant/Temporal_Shift/model.py", "Python", 12, 0, 0, 0, 0, 12, 24
"/Users/xuanpeichen/Desktop/code/python/openai/pycards/Instant/Timeless_Intervention/model.py", "Python", 12, 0, 0, 0, 0, 12, 24
"/Users/xuanpeichen/Desktop/code/python/openai/pycards/Instant/Veil_of_Serenity/model.py", "Python", 12, 0, 0, 0, 0, 12, 24
"/Users/xuanpeichen/Desktop/code/python/openai/pycards/Instant/Veiled_Concealment/model.py", "Python", 12, 0, 0, 0, 0, 12, 24
"/Users/xuanpeichen/Desktop/code/python/openai/pycards/Instant/Vengeful_Retribution/model.py", "Python", 12, 0, 0, 0, 0, 12, 24
"/Users/xuanpeichen/Desktop/code/python/openai/pycards/Instant/Verdant_Growth/model.py", "Python", 12, 0, 0, 0, 0, 12, 24
"/Users/xuanpeichen/Desktop/code/python/openai/pycards/Instant/Wild_Growth/model.py", "Python", 12, 0, 0, 0, 0, 12, 24
"/Users/xuanpeichen/Desktop/code/python/openai/pycards/Instant/Wild_Growth_Rush/model.py", "Python", 12, 0, 0, 0, 0, 12, 24
"/Users/xuanpeichen/Desktop/code/python/openai/pycards/__init__.py", "Python", 170, 0, 0, 0, 0, 1, 171
"/Users/xuanpeichen/Desktop/code/python/openai/pycards/creature/Aetherweaver/model.py", "Python", 15, 0, 0, 0, 0, 12, 27
"/Users/xuanpeichen/Desktop/code/python/openai/pycards/creature/Angelic_Protector/model.py", "Python", 15, 0, 0, 0, 0, 12, 27
"/Users/xuanpeichen/Desktop/code/python/openai/pycards/creature/Avacyn__Guardian_of_Hope/model.py", "Python", 15, 0, 0, 0, 0, 12, 27
"/Users/xuanpeichen/Desktop/code/python/openai/pycards/creature/Blightsteel_Colossus/model.py", "Python", 15, 0, 0, 0, 0, 12, 27
"/Users/xuanpeichen/Desktop/code/python/openai/pycards/creature/Celestial_Guardian/model.py", "Python", 15, 0, 0, 0, 0, 12, 27
"/Users/xuanpeichen/Desktop/code/python/openai/pycards/creature/Celestial_Herald/model.py", "Python", 15, 0, 0, 0, 0, 12, 27
"/Users/xuanpeichen/Desktop/code/python/openai/pycards/creature/Celestial_Sentinel/model.py", "Python", 15, 0, 0, 0, 0, 12, 27
"/Users/xuanpeichen/Desktop/code/python/openai/pycards/creature/Celestial_Seraph/model.py", "Python", 15, 0, 0, 0, 0, 12, 27
"/Users/xuanpeichen/Desktop/code/python/openai/pycards/creature/Celestial_Skyweaver/model.py", "Python", 15, 0, 0, 0, 0, 12, 27
"/Users/xuanpeichen/Desktop/code/python/openai/pycards/creature/Chronostrider/model.py", "Python", 15, 0, 0, 0, 0, 12, 27
"/Users/xuanpeichen/Desktop/code/python/openai/pycards/creature/Dreamweaver_Archivist/model.py", "Python", 15, 0, 0, 0, 0, 12, 27
"/Users/xuanpeichen/Desktop/code/python/openai/pycards/creature/Elite_Squire/model.py", "Python", 15, 0, 0, 0, 0, 12, 27
"/Users/xuanpeichen/Desktop/code/python/openai/pycards/creature/Elvish_Trailblazer/model.py", "Python", 15, 0, 0, 0, 0, 12, 27
"/Users/xuanpeichen/Desktop/code/python/openai/pycards/creature/Emberheart_Salamander/model.py", "Python", 15, 0, 0, 0, 0, 12, 27
"/Users/xuanpeichen/Desktop/code/python/openai/pycards/creature/Essence_Channeler/model.py", "Python", 15, 0, 0, 0, 0, 12, 27
"/Users/xuanpeichen/Desktop/code/python/openai/pycards/creature/Eternal_Phoenix/model.py", "Python", 15, 0, 0, 0, 0, 12, 27
"/Users/xuanpeichen/Desktop/code/python/openai/pycards/creature/Flame_Tinkerer/model.py", "Python", 15, 0, 0, 0, 0, 12, 27
"/Users/xuanpeichen/Desktop/code/python/openai/pycards/creature/Flameblade_Pyromancer/model.py", "Python", 15, 0, 0, 0, 0, 12, 27
"/Users/xuanpeichen/Desktop/code/python/openai/pycards/creature/Harbinger_of_the_Eternal_Tides/model.py", "Python", 15, 0, 0, 0, 0, 12, 27
"/Users/xuanpeichen/Desktop/code/python/openai/pycards/creature/Igni_the_Pyromancer/model.py", "Python", 15, 0, 0, 0, 0, 12, 27
"/Users/xuanpeichen/Desktop/code/python/openai/pycards/creature/Inferno_Titan/model.py", "Python", 15, 0, 0, 0, 0, 12, 27
"/Users/xuanpeichen/Desktop/code/python/openai/pycards/creature/Kothar_the_Soul_Reaper/model.py", "Python", 15, 0, 0, 0, 0, 12, 27
"/Users/xuanpeichen/Desktop/code/python/openai/pycards/creature/Luminous_Guardian/model.py", "Python", 15, 0, 0, 0, 0, 12, 27
"/Users/xuanpeichen/Desktop/code/python/openai/pycards/creature/Merfolk_Wayfinder/model.py", "Python", 15, 0, 0, 0, 0, 12, 27
"/Users/xuanpeichen/Desktop/code/python/openai/pycards/creature/Mindshaper_Sphinx/model.py", "Python", 15, 0, 0, 0, 0, 12, 27
"/Users/xuanpeichen/Desktop/code/python/openai/pycards/creature/Mistweaver_Adept/model.py", "Python", 15, 0, 0, 0, 0, 12, 27
"/Users/xuanpeichen/Desktop/code/python/openai/pycards/creature/Mistweaver_Drake/model.py", "Python", 15, 0, 0, 0, 0, 12, 27
"/Users/xuanpeichen/Desktop/code/python/openai/pycards/creature/Mystic_Tidecaller/model.py", "Python", 15, 0, 0, 0, 0, 12, 27
"/Users/xuanpeichen/Desktop/code/python/openai/pycards/creature/Night_Stalker__/model.py", "Python", 15, 0, 0, 0, 0, 12, 27
"/Users/xuanpeichen/Desktop/code/python/openai/pycards/creature/Nighthaunt_Assassin/model.py", "Python", 15, 0, 0, 0, 0, 12, 27
"/Users/xuanpeichen/Desktop/code/python/openai/pycards/creature/Nyxborn_Serpent/model.py", "Python", 15, 0, 0, 0, 0, 12, 27
"/Users/xuanpeichen/Desktop/code/python/openai/pycards/creature/Oblivion_Devourer/model.py", "Python", 15, 0, 0, 0, 0, 12, 27
"/Users/xuanpeichen/Desktop/code/python/openai/pycards/creature/Pious_Courser/model.py", "Python", 15, 0, 0, 0, 0, 12, 27
"/Users/xuanpeichen/Desktop/code/python/openai/pycards/creature/Raging_Firekin/model.py", "Python", 15, 0, 0, 0, 0, 12, 27
"/Users/xuanpeichen/Desktop/code/python/openai/pycards/creature/Ravaging_Ghoul/model.py", "Python", 15, 0, 0, 0, 0, 12, 27
"/Users/xuanpeichen/Desktop/code/python/openai/pycards/creature/Sage_of_the_Ancient_Grove/model.py", "Python", 15, 0, 0, 0, 0, 12, 27
"/Users/xuanpeichen/Desktop/code/python/openai/pycards/creature/Shadowtide_Leviathan/model.py", "Python", 15, 0, 0, 0, 0, 12, 27
"/Users/xuanpeichen/Desktop/code/python/openai/pycards/creature/Spectral_Harbinger/model.py", "Python", 15, 0, 0, 0, 0, 12, 27
"/Users/xuanpeichen/Desktop/code/python/openai/pycards/creature/Sunlit_Priestess/model.py", "Python", 15, 0, 0, 0, 0, 12, 27
"/Users/xuanpeichen/Desktop/code/python/openai/pycards/creature/Sylvan_Warden/model.py", "Python", 15, 0, 0, 0, 0, 12, 27
"/Users/xuanpeichen/Desktop/code/python/openai/pycards/creature/Thalassian_Tidecaller/model.py", "Python", 15, 0, 0, 0, 0, 12, 27
"/Users/xuanpeichen/Desktop/code/python/openai/pycards/creature/Thornroot_Druid/model.py", "Python", 15, 0, 0, 0, 0, 12, 27
"/Users/xuanpeichen/Desktop/code/python/openai/pycards/creature/Thornwood_Guardian/model.py", "Python", 15, 0, 0, 0, 0, 12, 27
"/Users/xuanpeichen/Desktop/code/python/openai/pycards/creature/Thornwood_Ranger/model.py", "Python", 15, 0, 0, 0, 0, 12, 27
"/Users/xuanpeichen/Desktop/code/python/openai/pycards/creature/Thornwood_Sentinel/model.py", "Python", 15, 0, 0, 0, 0, 12, 27
"/Users/xuanpeichen/Desktop/code/python/openai/pycards/creature/Thunderclap_Behemoth/model.py", "Python", 15, 0, 0, 0, 0, 12, 27
"/Users/xuanpeichen/Desktop/code/python/openai/pycards/creature/Tidal_Sprite/model.py", "Python", 15, 0, 0, 0, 0, 12, 27
"/Users/xuanpeichen/Desktop/code/python/openai/pycards/creature/Torrent_Elemental/model.py", "Python", 15, 0, 0, 0, 0, 12, 27
"/Users/xuanpeichen/Desktop/code/python/openai/pycards/creature/Verdant_Wyrm/model.py", "Python", 15, 0, 0, 0, 0, 12, 27
"/Users/xuanpeichen/Desktop/code/python/openai/pycards/creature/Voidwisp_Harbinger/model.py", "Python", 15, 0, 0, 0, 0, 12, 27
"/Users/xuanpeichen/Desktop/code/python/openai/pycards/creature/Vorinclex__Apex_of_Mutation/model.py", "Python", 15, 0, 0, 0, 0, 12, 27
"/Users/xuanpeichen/Desktop/code/python/openai/pycards/land/Aetheric_Nexus/model.py", "Python", 12, 0, 0, 0, 0, 12, 24
"/Users/xuanpeichen/Desktop/code/python/openai/pycards/land/Arcane_Haven/model.py", "Python", 12, 0, 0, 0, 0, 12, 24
"/Users/xuanpeichen/Desktop/code/python/openai/pycards/land/Arcane_Sanctuary/model.py", "Python", 12, 0, 0, 0, 0, 12, 24
"/Users/xuanpeichen/Desktop/code/python/openai/pycards/land/Celestial_Haven/model.py", "Python", 12, 0, 0, 0, 0, 12, 24
"/Users/xuanpeichen/Desktop/code/python/openai/pycards/land/Elysian_Grove/model.py", "Python", 12, 0, 0, 0, 0, 12, 24
"/Users/xuanpeichen/Desktop/code/python/openai/pycards/land/Luminous_Glade/model.py", "Python", 12, 0, 0, 0, 0, 12, 24
"/Users/xuanpeichen/Desktop/code/python/openai/pycards/land/Mystic_Reflection_Pool/model.py", "Python", 12, 0, 0, 0, 0, 12, 24
"/Users/xuanpeichen/Desktop/code/python/openai/pycards/land/Nexus_of_the_Eternal_Seas/model.py", "Python", 12, 0, 0, 0, 0, 12, 24
"/Users/xuanpeichen/Desktop/code/python/openai/pycards/land/Sanctum_of_Eternal_Flames/model.py", "Python", 12, 0, 0, 0, 0, 12, 24
"/Users/xuanpeichen/Desktop/code/python/openai/pycards/land/Sanctum_of_Verdant_Growth/model.py", "Python", 12, 0, 0, 0, 0, 12, 24
"/Users/xuanpeichen/Desktop/code/python/openai/pycards/land/Verdant_Sanctuary/model.py", "Python", 12, 0, 0, 0, 0, 12, 24
"/Users/xuanpeichen/Desktop/code/python/openai/pycards/land/Volcanic_Fumaroles/model.py", "Python", 12, 0, 0, 0, 0, 12, 24
"/Users/xuanpeichen/Desktop/code/python/openai/pycards/sorcery/Angelic_Blessing/model.py", "Python", 12, 0, 0, 0, 0, 12, 24
"/Users/xuanpeichen/Desktop/code/python/openai/pycards/sorcery/Arcane_Convergence/model.py", "Python", 12, 0, 0, 0, 0, 12, 24
"/Users/xuanpeichen/Desktop/code/python/openai/pycards/sorcery/Arcane_Torrent/model.py", "Python", 12, 0, 0, 0, 0, 12, 24
"/Users/xuanpeichen/Desktop/code/python/openai/pycards/sorcery/Call_of_the_Ancient_Ones/model.py", "Python", 12, 0, 0, 0, 0, 12, 24
"/Users/xuanpeichen/Desktop/code/python/openai/pycards/sorcery/Call_of_the_Tides/model.py", "Python", 12, 0, 0, 0, 0, 12, 24
"/Users/xuanpeichen/Desktop/code/python/openai/pycards/sorcery/Call_to_Unity/model.py", "Python", 12, 0, 0, 0, 0, 12, 24
"/Users/xuanpeichen/Desktop/code/python/openai/pycards/sorcery/Cataclysmic_Inferno/model.py", "Python", 12, 0, 0, 0, 0, 12, 24
"/Users/xuanpeichen/Desktop/code/python/openai/pycards/sorcery/Cataclysmic_Surge/model.py", "Python", 12, 0, 0, 0, 0, 12, 24
"/Users/xuanpeichen/Desktop/code/python/openai/pycards/sorcery/Celestial_Purge/model.py", "Python", 12, 0, 0, 0, 0, 12, 24
"/Users/xuanpeichen/Desktop/code/python/openai/pycards/sorcery/Celestial_Renewal/model.py", "Python", 12, 0, 0, 0, 0, 12, 24
"/Users/xuanpeichen/Desktop/code/python/openai/pycards/sorcery/Chaos_Unleashed/model.py", "Python", 12, 0, 0, 0, 0, 12, 24
"/Users/xuanpeichen/Desktop/code/python/openai/pycards/sorcery/Chaotic_Eruption/model.py", "Python", 12, 0, 0, 0, 0, 12, 24
"/Users/xuanpeichen/Desktop/code/python/openai/pycards/sorcery/Dark_Offering/model.py", "Python", 12, 0, 0, 0, 0, 12, 24
"/Users/xuanpeichen/Desktop/code/python/openai/pycards/sorcery/Demonic_Ascendance/model.py", "Python", 12, 0, 0, 0, 0, 12, 24
"/Users/xuanpeichen/Desktop/code/python/openai/pycards/sorcery/Divine_Intervention/model.py", "Python", 12, 0, 0, 0, 0, 12, 24
"/Users/xuanpeichen/Desktop/code/python/openai/pycards/sorcery/Divine_Offering/model.py", "Python", 12, 0, 0, 0, 0, 12, 24
"/Users/xuanpeichen/Desktop/code/python/openai/pycards/sorcery/Divine_Rebirth/model.py", "Python", 12, 0, 0, 0, 0, 12, 24
"/Users/xuanpeichen/Desktop/code/python/openai/pycards/sorcery/Divine_Reckoning/model.py", "Python", 12, 0, 0, 0, 0, 12, 24
"/Users/xuanpeichen/Desktop/code/python/openai/pycards/sorcery/Eldritch_Rebirth/model.py", "Python", 12, 0, 0, 0, 0, 12, 24
"/Users/xuanpeichen/Desktop/code/python/openai/pycards/sorcery/Ephemeral_Eruption/model.py", "Python", 12, 0, 0, 0, 0, 12, 24
"/Users/xuanpeichen/Desktop/code/python/openai/pycards/sorcery/Fiery_Burst/model.py", "Python", 12, 0, 0, 0, 0, 12, 24
"/Users/xuanpeichen/Desktop/code/python/openai/pycards/sorcery/Flames_of_Fury/model.py", "Python", 12, 0, 0, 0, 0, 12, 24
"/Users/xuanpeichen/Desktop/code/python/openai/pycards/sorcery/Fleeting_Insight/model.py", "Python", 12, 0, 0, 0, 0, 12, 24
"/Users/xuanpeichen/Desktop/code/python/openai/pycards/sorcery/Harvest_Blessing/model.py", "Python", 12, 0, 0, 0, 0, 12, 24
"/Users/xuanpeichen/Desktop/code/python/openai/pycards/sorcery/Mind_s_Insight/model.py", "Python", 12, 0, 0, 0, 0, 12, 24
"/Users/xuanpeichen/Desktop/code/python/openai/pycards/sorcery/Mindful_Manipulation/model.py", "Python", 12, 0, 0, 0, 0, 12, 24
"/Users/xuanpeichen/Desktop/code/python/openai/pycards/sorcery/Mindful_Reflection/model.py", "Python", 12, 0, 0, 0, 0, 12, 24
"/Users/xuanpeichen/Desktop/code/python/openai/pycards/sorcery/Mystic_Insight/model.py", "Python", 12, 0, 0, 0, 0, 12, 24
"/Users/xuanpeichen/Desktop/code/python/openai/pycards/sorcery/Mystic_Reversal/model.py", "Python", 12, 0, 0, 0, 0, 12, 24
"/Users/xuanpeichen/Desktop/code/python/openai/pycards/sorcery/Natural_Growth/model.py", "Python", 12, 0, 0, 0, 0, 12, 24
"/Users/xuanpeichen/Desktop/code/python/openai/pycards/sorcery/Natural_Harmony/model.py", "Python", 12, 0, 0, 0, 0, 12, 24
"/Users/xuanpeichen/Desktop/code/python/openai/pycards/sorcery/Naturalize/model.py", "Python", 12, 0, 0, 0, 0, 12, 24
"/Users/xuanpeichen/Desktop/code/python/openai/pycards/sorcery/Nature_s_Embrace/model.py", "Python", 12, 0, 0, 0, 0, 12, 24
"/Users/xuanpeichen/Desktop/code/python/openai/pycards/sorcery/Overgrowth/model.py", "Python", 12, 0, 0, 0, 0, 12, 24
"/Users/xuanpeichen/Desktop/code/python/openai/pycards/sorcery/Rift_in_Reality/model.py", "Python", 12, 0, 0, 0, 0, 12, 24
"/Users/xuanpeichen/Desktop/code/python/openai/pycards/sorcery/Righteous_Conviction/model.py", "Python", 12, 0, 0, 0, 0, 12, 24
"/Users/xuanpeichen/Desktop/code/python/openai/pycards/sorcery/Soul_Siphon/model.py", "Python", 12, 0, 0, 0, 0, 12, 24
"/Users/xuanpeichen/Desktop/code/python/openai/pycards/sorcery/Spectral_Embrace/model.py", "Python", 12, 0, 0, 0, 0, 12, 24
"/Users/xuanpeichen/Desktop/code/python/openai/pycards/sorcery/Temporal_Distortion/model.py", "Python", 12, 0, 0, 0, 0, 12, 24
"/Users/xuanpeichen/Desktop/code/python/openai/pycards/sorcery/Temporal_Flux/model.py", "Python", 12, 0, 0, 0, 0, 12, 24
"/Users/xuanpeichen/Desktop/code/python/openai/pycards/sorcery/Time_Rift_Convergence/model.py", "Python", 12, 0, 0, 0, 0, 12, 24
"/Users/xuanpeichen/Desktop/code/python/openai/pycards/sorcery/Torrential_Manipulation/model.py", "Python", 12, 0, 0, 0, 0, 12, 24
"/Users/xuanpeichen/Desktop/code/python/openai/pycards/sorcery/Treasure_Hunt/model.py", "Python", 12, 0, 0, 0, 0, 12, 24
"/Users/xuanpeichen/Desktop/code/python/openai/pycards/sorcery/Unleash_the_Elements/model.py", "Python", 12, 0, 0, 0, 0, 12, 24
"/Users/xuanpeichen/Desktop/code/python/openai/pycards/sorcery/Unyielding_Resolve/model.py", "Python", 12, 0, 0, 0, 0, 12, 24
"/Users/xuanpeichen/Desktop/code/python/openai/pycards/sorcery/Vampiric_Revelry/model.py", "Python", 12, 0, 0, 0, 0, 12, 24
"/Users/xuanpeichen/Desktop/code/python/openai/pycards/sorcery/Verdant_Genesis/model.py", "Python", 12, 0, 0, 0, 0, 12, 24
"/Users/xuanpeichen/Desktop/code/python/openai/pycards/sorcery/Wild_Growth/model.py", "Python", 12, 0, 0, 0, 0, 12, 24
"/Users/xuanpeichen/Desktop/code/python/openai/server.py", "Python", 36, 0, 0, 0, 1, 16, 53
"/Users/xuanpeichen/Desktop/code/python/openai/server2.py", "Python", -39, 0, 0, 0, 0, -16, -55
"/Users/xuanpeichen/Desktop/code/python/openai/server_function_tool.py", "Python", 5, 0, 0, 0, 0, 3, 8
"/Users/xuanpeichen/Desktop/code/python/openai/test.py", "Python", -23, 0, 0, 0, -15, -11, -49
"/Users/xuanpeichen/Desktop/code/python/openai/webpages/error.css", "CSS", 0, 21, 0, 0, 0, 2, 23
"/Users/xuanpeichen/Desktop/code/python/openai/webpages/error.js", "JavaScript", 0, 0, 17, 0, 1, 2, 20
"/Users/xuanpeichen/Desktop/code/python/openai/webpages/homepage/decks.js", "JavaScript", 0, 0, 35, 0, 0, 1, 36
"/Users/xuanpeichen/Desktop/code/python/openai/webpages/homepage/home.js", "JavaScript", 0, 0, 76, 0, 1, 22, 99
"/Users/xuanpeichen/Desktop/code/python/openai/webpages/homepage/homepage.js", "JavaScript", 0, 0, -27, 0, 2, -5, -30
"/Users/xuanpeichen/Desktop/code/python/openai/webpages/homepage/protectpage.html", "HTML", 0, 0, 0, 6, 0, -1, 5
"/Users/xuanpeichen/Desktop/code/python/openai/webpages/security.js", "JavaScript", 0, 0, 46, 0, 0, 4, 50
"Total", "-", 2907, 21, 147, 6, 25, 2390, 5496